+/-     = +/-                       player
2CP     = 2nd Chance Pts            player, team
2JA     = 2PJFGA                    player, team
2JM     = 2PJFGM                    player, team
2PA     = 2PFGA                     player, team                       
2PM     = 2PFGM                     player, team
3PA     = 3PFGA                     player, team
3PM     = 3PFGM                     player, team
Ast     = Assists                   player, team
BPts    = Bench Pts                 team
CS      = Court Status              player
DR      = Def Reb                   player, team
FC      = Fouls                     player, team
FD      = Fouls Drawn               player, team
FGA     = FGA                       player, team
FGM     = FGM                       player, team
FTA     = FTA                       player, team
FTM     = FTM                       player, team
Game    = Game                      player, team
InA     = Inside FGA                player, team
IFC     = Inside Fouls              player, team
IFD     = Inside Fouls Drawn        player, team
InM     = Inside FGM                player, team
InP     = Inside Pts                player, team
LChgs   = Lead Changes              match
MaxL    = Largest Lead              team
MUPt    = Most Unanswered Pts       team
OR      = Off Reb                   player, team
Pass    = Passes                    player, team
PBA     = Put Backs A               player, team
PBM     = Put Backs M               player, team
PeriodScores = Period Scores        team
PFC     = Per Fouls                 player, team
PFD     = Perimeter Fouls Drawn     player, team
Poss    = Possessions               team
Pts     = Points                    player, team
St      = Starter (1/0)             player
Ties    = Ties                      match
Time    = Court Time                player
TR      = Tot Reb                   player, team
TPA     = Team Points Against       player
TPF     = Team Points For           player
Tchs    = Touches                   player, team
Type    = Game Type                 match
Yr      = Year                      match